...................
...................
                   
..+.-+##. .... ....
..|..|+--.+.+-.-+..
..|..||...|.|...|..
..+--+|...|.|...|..
......|...|.|...|..
......+---+.|..>|..
.........0..+---+..
...................